"filename", "language", "pip requirements", "Python", "HTML", "Markdown", "comment", "blank", "total"
"d:\django projects\Full project code\adnan-game-animal\1.html", "HTML", 0, 0, 45, 0, 4, 3, 52
"d:\django projects\Full project code\adnan-game-animal\README.md", "Markdown", 0, 0, 0, 3, 0, 0, 3
"d:\django projects\Full project code\adnan-game-animal\accounts\__init__.py", "Python", 0, 0, 0, 0, 0, 1, 1
"d:\django projects\Full project code\adnan-game-animal\accounts\admin.py", "Python", 0, 1, 0, 0, 1, 2, 4
"d:\django projects\Full project code\adnan-game-animal\accounts\apps.py", "Python", 0, 4, 0, 0, 0, 3, 7
"d:\django projects\Full project code\adnan-game-animal\accounts\migrations\0001_initial.py", "Python", 0, 17, 0, 0, 1, 7, 25
"d:\django projects\Full project code\adnan-game-animal\accounts\migrations\0002_room_created_players_room_created_table_and_more.py", "Python", 0, 27, 0, 0, 1, 6, 34
"d:\django projects\Full project code\adnan-game-animal\accounts\migrations\0003_played.py", "Python", 0, 15, 0, 0, 1, 6, 22
"d:\django projects\Full project code\adnan-game-animal\accounts\migrations\0004_room_created_date.py", "Python", 0, 14, 0, 0, 1, 6, 21
"d:\django projects\Full project code\adnan-game-animal\accounts\migrations\__init__.py", "Python", 0, 0, 0, 0, 0, 1, 1
"d:\django projects\Full project code\adnan-game-animal\accounts\models.py", "Python", 0, 13, 0, 0, 0, 6, 19
"d:\django projects\Full project code\adnan-game-animal\accounts\templatetags\num.py", "Python", 0, 9, 0, 0, 0, 2, 11
"d:\django projects\Full project code\adnan-game-animal\accounts\tests.py", "Python", 0, 1, 0, 0, 1, 2, 4
"d:\django projects\Full project code\adnan-game-animal\accounts\urls.py", "Python", 0, 24, 0, 0, 0, 8, 32
"d:\django projects\Full project code\adnan-game-animal\accounts\views.py", "Python", 0, 348, 0, 0, 9, 87, 444
"d:\django projects\Full project code\adnan-game-animal\animal\__init__.py", "Python", 0, 0, 0, 0, 0, 1, 1
"d:\django projects\Full project code\adnan-game-animal\animal\admin.py", "Python", 0, 6, 0, 0, 0, 3, 9
"d:\django projects\Full project code\adnan-game-animal\animal\apps.py", "Python", 0, 4, 0, 0, 0, 3, 7
"d:\django projects\Full project code\adnan-game-animal\animal\channels\__init__.py", "Python", 0, 8, 0, 0, 0, 4, 12
"d:\django projects\Full project code\adnan-game-animal\animal\channels\apps.py", "Python", 0, 9, 0, 0, 4, 7, 20
"d:\django projects\Full project code\adnan-game-animal\animal\channels\auth.py", "Python", 0, 128, 0, 0, 40, 23, 191
"d:\django projects\Full project code\adnan-game-animal\animal\channels\consumer.py", "Python", 0, 66, 0, 0, 47, 21, 134
"d:\django projects\Full project code\adnan-game-animal\animal\channels\db.py", "Python", 0, 10, 0, 0, 4, 6, 20
"d:\django projects\Full project code\adnan-game-animal\animal\channels\exceptions.py", "Python", 0, 16, 0, 0, 27, 23, 66
"d:\django projects\Full project code\adnan-game-animal\animal\channels\generic\__init__.py", "Python", 0, 0, 0, 0, 0, 1, 1
"d:\django projects\Full project code\adnan-game-animal\animal\channels\generic\http.py", "Python", 0, 39, 0, 0, 40, 13, 92
"d:\django projects\Full project code\adnan-game-animal\animal\channels\generic\websocket.py", "Python", 0, 155, 0, 0, 82, 43, 280
"d:\django projects\Full project code\adnan-game-animal\animal\channels\hacks.py", "Python", 0, 6, 0, 0, 5, 3, 14
"d:\django projects\Full project code\adnan-game-animal\animal\channels\http.py", "Python", 0, 256, 0, 0, 81, 31, 368
"d:\django projects\Full project code\adnan-game-animal\animal\channels\layers.py", "Python", 0, 212, 0, 0, 98, 56, 366
"d:\django projects\Full project code\adnan-game-animal\animal\channels\management\__init__.py", "Python", 0, 0, 0, 0, 0, 1, 1
"d:\django projects\Full project code\adnan-game-animal\animal\channels\management\commands\__init__.py", "Python", 0, 0, 0, 0, 0, 1, 1
"d:\django projects\Full project code\adnan-game-animal\animal\channels\management\commands\runserver.py", "Python", 0, 134, 0, 0, 21, 16, 171
"d:\django projects\Full project code\adnan-game-animal\animal\channels\management\commands\runworker.py", "Python", 0, 35, 0, 0, 3, 9, 47
"d:\django projects\Full project code\adnan-game-animal\animal\channels\middleware.py", "Python", 0, 6, 0, 0, 18, 3, 27
"d:\django projects\Full project code\adnan-game-animal\animal\channels\routing.py", "Python", 0, 117, 0, 0, 52, 26, 195
"d:\django projects\Full project code\adnan-game-animal\animal\channels\security\__init__.py", "Python", 0, 0, 0, 0, 0, 1, 1
"d:\django projects\Full project code\adnan-game-animal\animal\channels\security\websocket.py", "Python", 0, 69, 0, 0, 68, 17, 154
"d:\django projects\Full project code\adnan-game-animal\animal\channels\sessions.py", "Python", 0, 175, 0, 0, 65, 29, 269
"d:\django projects\Full project code\adnan-game-animal\animal\channels\signals.py", "Python", 0, 5, 0, 0, 1, 3, 9
"d:\django projects\Full project code\adnan-game-animal\animal\channels\staticfiles.py", "Python", 0, 39, 0, 0, 27, 17, 83
"d:\django projects\Full project code\adnan-game-animal\animal\channels\testing\__init__.py", "Python", 0, 10, 0, 0, 0, 3, 13
"d:\django projects\Full project code\adnan-game-animal\animal\channels\testing\http.py", "Python", 0, 34, 0, 0, 17, 6, 57
"d:\django projects\Full project code\adnan-game-animal\animal\channels\testing\live.py", "Python", 0, 45, 0, 0, 9, 14, 68
"d:\django projects\Full project code\adnan-game-animal\animal\channels\testing\websocket.py", "Python", 0, 58, 0, 0, 34, 11, 103
"d:\django projects\Full project code\adnan-game-animal\animal\channels\utils.py", "Python", 0, 41, 0, 0, 15, 5, 61
"d:\django projects\Full project code\adnan-game-animal\animal\channels\worker.py", "Python", 0, 23, 0, 0, 15, 7, 45
"d:\django projects\Full project code\adnan-game-animal\animal\consumers.py", "Python", 0, 638, 0, 0, 14, 42, 694
"d:\django projects\Full project code\adnan-game-animal\animal\migrations\0001_initial.py", "Python", 0, 33, 0, 0, 1, 7, 41
"d:\django projects\Full project code\adnan-game-animal\animal\migrations\0002_alter_summeryofletter_time.py", "Python", 0, 13, 0, 0, 1, 6, 20
"d:\django projects\Full project code\adnan-game-animal\animal\migrations\0003_alter_summeryofletter_all_letter_as_and_more.py", "Python", 0, 18, 0, 0, 1, 6, 25
"d:\django projects\Full project code\adnan-game-animal\animal\migrations\0004_alter_summeryofletter_time.py", "Python", 0, 13, 0, 0, 1, 6, 20
"d:\django projects\Full project code\adnan-game-animal\animal\migrations\0005_startingroom_alter_summeryofletter_time.py", "Python", 0, 21, 0, 0, 1, 6, 28
"d:\django projects\Full project code\adnan-game-animal\animal\migrations\0006_alter_summeryofletter_time.py", "Python", 0, 13, 0, 0, 1, 6, 20
"d:\django projects\Full project code\adnan-game-animal\animal\migrations\0007_alter_summeryofletter_time.py", "Python", 0, 13, 0, 0, 1, 6, 20
"d:\django projects\Full project code\adnan-game-animal\animal\migrations\0008_delete_startingroom_alter_summeryofletter_time.py", "Python", 0, 16, 0, 0, 1, 6, 23
"d:\django projects\Full project code\adnan-game-animal\animal\migrations\0009_alter_summeryofletter_time.py", "Python", 0, 13, 0, 0, 1, 6, 20
"d:\django projects\Full project code\adnan-game-animal\animal\migrations\0010_alter_summeryofletter_time.py", "Python", 0, 13, 0, 0, 1, 6, 20
"d:\django projects\Full project code\adnan-game-animal\animal\migrations\0011_alter_summeryofletter_time.py", "Python", 0, 13, 0, 0, 1, 6, 20
"d:\django projects\Full project code\adnan-game-animal\animal\migrations\0012_array_alter_summeryofletter_time.py", "Python", 0, 21, 0, 0, 1, 6, 28
"d:\django projects\Full project code\adnan-game-animal\animal\migrations\0013_alter_array_status_alter_summeryofletter_time.py", "Python", 0, 18, 0, 0, 1, 6, 25
"d:\django projects\Full project code\adnan-game-animal\animal\migrations\0014_alter_array_status_alter_summeryofletter_time.py", "Python", 0, 18, 0, 0, 1, 6, 25
"d:\django projects\Full project code\adnan-game-animal\animal\migrations\0015_players_alter_summeryofletter_time.py", "Python", 0, 21, 0, 0, 1, 6, 28
"d:\django projects\Full project code\adnan-game-animal\animal\migrations\0016_alter_players_players_alter_summeryofletter_time.py", "Python", 0, 18, 0, 0, 1, 6, 25
"d:\django projects\Full project code\adnan-game-animal\animal\migrations\0017_alter_adnan_test11_letter_alter_summeryofletter_time.py", "Python", 0, 18, 0, 0, 1, 6, 25
"d:\django projects\Full project code\adnan-game-animal\animal\migrations\0018_alter_summeryofletter_time.py", "Python", 0, 13, 0, 0, 1, 6, 20
"d:\django projects\Full project code\adnan-game-animal\animal\migrations\0019_alter_summeryofletter_time.py", "Python", 0, 14, 0, 0, 1, 6, 21
"d:\django projects\Full project code\adnan-game-animal\animal\migrations\0020_alter_summeryofletter_time.py", "Python", 0, 14, 0, 0, 1, 6, 21
"d:\django projects\Full project code\adnan-game-animal\animal\migrations\0021_alter_summeryofletter_time.py", "Python", 0, 14, 0, 0, 1, 6, 21
"d:\django projects\Full project code\adnan-game-animal\animal\migrations\0022_alter_summeryofletter_time.py", "Python", 0, 14, 0, 0, 1, 6, 21
"d:\django projects\Full project code\adnan-game-animal\animal\migrations\0023_alter_summeryofletter_time.py", "Python", 0, 14, 0, 0, 1, 6, 21
"d:\django projects\Full project code\adnan-game-animal\animal\migrations\0024_alter_summeryofletter_time.py", "Python", 0, 14, 0, 0, 1, 6, 21
"d:\django projects\Full project code\adnan-game-animal\animal\migrations\0025_alter_summeryofletter_time.py", "Python", 0, 14, 0, 0, 1, 6, 21
"d:\django projects\Full project code\adnan-game-animal\animal\migrations\0026_alter_summeryofletter_time.py", "Python", 0, 14, 0, 0, 1, 6, 21
"d:\django projects\Full project code\adnan-game-animal\animal\migrations\0027_room_created_alter_summeryofletter_time.py", "Python", 0, 24, 0, 0, 1, 6, 31
"d:\django projects\Full project code\adnan-game-animal\animal\migrations\0028_alter_room_created_room_created_and_more.py", "Python", 0, 19, 0, 0, 1, 6, 26
"d:\django projects\Full project code\adnan-game-animal\animal\migrations\0029_alter_summeryofletter_time.py", "Python", 0, 14, 0, 0, 1, 6, 21
"d:\django projects\Full project code\adnan-game-animal\animal\migrations\0030_alter_summeryofletter_time.py", "Python", 0, 14, 0, 0, 1, 6, 21
"d:\django projects\Full project code\adnan-game-animal\animal\migrations\0031_alter_summeryofletter_time.py", "Python", 0, 14, 0, 0, 1, 6, 21
"d:\django projects\Full project code\adnan-game-animal\animal\migrations\0032_alter_summeryofletter_time.py", "Python", 0, 14, 0, 0, 1, 6, 21
"d:\django projects\Full project code\adnan-game-animal\animal\migrations\0033_alter_summeryofletter_time.py", "Python", 0, 14, 0, 0, 1, 6, 21
"d:\django projects\Full project code\adnan-game-animal\animal\migrations\0034_alter_summeryofletter_time.py", "Python", 0, 14, 0, 0, 1, 6, 21
"d:\django projects\Full project code\adnan-game-animal\animal\migrations\0035_alter_summeryofletter_time.py", "Python", 0, 14, 0, 0, 1, 6, 21
"d:\django projects\Full project code\adnan-game-animal\animal\migrations\0036_alter_summeryofletter_time.py", "Python", 0, 14, 0, 0, 1, 6, 21
"d:\django projects\Full project code\adnan-game-animal\animal\migrations\0037_alter_summeryofletter_time.py", "Python", 0, 14, 0, 0, 1, 6, 21
"d:\django projects\Full project code\adnan-game-animal\animal\migrations\0038_alter_summeryofletter_time.py", "Python", 0, 14, 0, 0, 1, 6, 21
"d:\django projects\Full project code\adnan-game-animal\animal\migrations\0039_alter_summeryofletter_time.py", "Python", 0, 14, 0, 0, 1, 6, 21
"d:\django projects\Full project code\adnan-game-animal\animal\migrations\0040_alter_summeryofletter_time.py", "Python", 0, 14, 0, 0, 1, 6, 21
"d:\django projects\Full project code\adnan-game-animal\animal\migrations\0041_alter_summeryofletter_time.py", "Python", 0, 14, 0, 0, 1, 6, 21
"d:\django projects\Full project code\adnan-game-animal\animal\migrations\0042_alter_summeryofletter_time.py", "Python", 0, 14, 0, 0, 1, 6, 21
"d:\django projects\Full project code\adnan-game-animal\animal\migrations\0043_alter_summeryofletter_time.py", "Python", 0, 14, 0, 0, 1, 6, 21
"d:\django projects\Full project code\adnan-game-animal\animal\migrations\0044_alter_summeryofletter_time.py", "Python", 0, 14, 0, 0, 1, 6, 21
"d:\django projects\Full project code\adnan-game-animal\animal\migrations\0045_lang_alter_summeryofletter_time.py", "Python", 0, 21, 0, 0, 1, 6, 28
"d:\django projects\Full project code\adnan-game-animal\animal\migrations\0046_lang_user_alter_summeryofletter_time.py", "Python", 0, 19, 0, 0, 1, 6, 26
"d:\django projects\Full project code\adnan-game-animal\animal\migrations\0047_alter_lang_user_alter_summeryofletter_time.py", "Python", 0, 19, 0, 0, 1, 6, 26
"d:\django projects\Full project code\adnan-game-animal\animal\migrations\0048_alter_summeryofletter_time.py", "Python", 0, 14, 0, 0, 1, 6, 21
"d:\django projects\Full project code\adnan-game-animal\animal\migrations\0049_alter_summeryofletter_time.py", "Python", 0, 14, 0, 0, 1, 6, 21
"d:\django projects\Full project code\adnan-game-animal\animal\migrations\0050_alter_summeryofletter_time.py", "Python", 0, 14, 0, 0, 1, 6, 21
"d:\django projects\Full project code\adnan-game-animal\animal\migrations\0051_alter_summeryofletter_time.py", "Python", 0, 14, 0, 0, 1, 6, 21
"d:\django projects\Full project code\adnan-game-animal\animal\migrations\0052_alter_summeryofletter_time.py", "Python", 0, 14, 0, 0, 1, 6, 21
"d:\django projects\Full project code\adnan-game-animal\animal\migrations\0053_alter_summeryofletter_time.py", "Python", 0, 14, 0, 0, 1, 6, 21
"d:\django projects\Full project code\adnan-game-animal\animal\migrations\0054_alter_summeryofletter_time.py", "Python", 0, 14, 0, 0, 1, 6, 21
"d:\django projects\Full project code\adnan-game-animal\animal\migrations\0055_alter_summeryofletter_time.py", "Python", 0, 14, 0, 0, 1, 6, 21
"d:\django projects\Full project code\adnan-game-animal\animal\migrations\0056_alter_summeryofletter_time.py", "Python", 0, 14, 0, 0, 1, 6, 21
"d:\django projects\Full project code\adnan-game-animal\animal\migrations\0057_alter_summeryofletter_time.py", "Python", 0, 14, 0, 0, 1, 6, 21
"d:\django projects\Full project code\adnan-game-animal\animal\migrations\0058_alter_summeryofletter_time.py", "Python", 0, 14, 0, 0, 1, 6, 21
"d:\django projects\Full project code\adnan-game-animal\animal\migrations\0059_alter_summeryofletter_time.py", "Python", 0, 14, 0, 0, 1, 6, 21
"d:\django projects\Full project code\adnan-game-animal\animal\migrations\0060_alter_summeryofletter_time.py", "Python", 0, 14, 0, 0, 1, 6, 21
"d:\django projects\Full project code\adnan-game-animal\animal\migrations\0061_alter_summeryofletter_time.py", "Python", 0, 14, 0, 0, 1, 6, 21
"d:\django projects\Full project code\adnan-game-animal\animal\migrations\0062_alter_summeryofletter_time.py", "Python", 0, 14, 0, 0, 1, 6, 21
"d:\django projects\Full project code\adnan-game-animal\animal\migrations\__init__.py", "Python", 0, 0, 0, 0, 0, 1, 1
"d:\django projects\Full project code\adnan-game-animal\animal\models.py", "Python", 0, 39, 0, 0, 0, 6, 45
"d:\django projects\Full project code\adnan-game-animal\animal\routing.py", "Python", 0, 5, 0, 0, 0, 2, 7
"d:\django projects\Full project code\adnan-game-animal\animal\tests.py", "Python", 0, 1, 0, 0, 1, 2, 4
"d:\django projects\Full project code\adnan-game-animal\animal\urls.py", "Python", 0, 30, 0, 0, 0, 8, 38
"d:\django projects\Full project code\adnan-game-animal\animal\views.py", "Python", 0, 584, 0, 0, 7, 174, 765
"d:\django projects\Full project code\adnan-game-animal\animals\__init__.py", "Python", 0, 0, 0, 0, 0, 1, 1
"d:\django projects\Full project code\adnan-game-animal\animals\asgi.py", "Python", 0, 21, 0, 0, 1, 4, 26
"d:\django projects\Full project code\adnan-game-animal\animals\settings.py", "Python", 0, 97, 0, 0, 27, 32, 156
"d:\django projects\Full project code\adnan-game-animal\animals\urls.py", "Python", 0, 7, 0, 0, 15, 2, 24
"d:\django projects\Full project code\adnan-game-animal\animals\wsgi.py", "Python", 0, 4, 0, 0, 8, 5, 17
"d:\django projects\Full project code\adnan-game-animal\gameadmin\__init__.py", "Python", 0, 0, 0, 0, 0, 1, 1
"d:\django projects\Full project code\adnan-game-animal\gameadmin\admin.py", "Python", 0, 1, 0, 0, 1, 2, 4
"d:\django projects\Full project code\adnan-game-animal\gameadmin\apps.py", "Python", 0, 4, 0, 0, 0, 3, 7
"d:\django projects\Full project code\adnan-game-animal\gameadmin\consumers.py", "Python", 0, 141, 0, 0, 1, 29, 171
"d:\django projects\Full project code\adnan-game-animal\gameadmin\migrations\0001_initial.py", "Python", 0, 16, 0, 0, 1, 7, 24
"d:\django projects\Full project code\adnan-game-animal\gameadmin\migrations\0002_room.py", "Python", 0, 14, 0, 0, 1, 6, 21
"d:\django projects\Full project code\adnan-game-animal\gameadmin\migrations\0003_startingroom_admin_startingroom_time.py", "Python", 0, 18, 0, 0, 1, 6, 25
"d:\django projects\Full project code\adnan-game-animal\gameadmin\migrations\__init__.py", "Python", 0, 0, 0, 0, 0, 1, 1
"d:\django projects\Full project code\adnan-game-animal\gameadmin\models.py", "Python", 0, 12, 0, 0, 0, 4, 16
"d:\django projects\Full project code\adnan-game-animal\gameadmin\routing.py", "Python", 0, 5, 0, 0, 0, 2, 7
"d:\django projects\Full project code\adnan-game-animal\gameadmin\tests.py", "Python", 0, 1, 0, 0, 1, 2, 4
"d:\django projects\Full project code\adnan-game-animal\gameadmin\views.py", "Python", 0, 1, 0, 0, 1, 2, 4
"d:\django projects\Full project code\adnan-game-animal\letter\__init__.py", "Python", 0, 0, 0, 0, 0, 1, 1
"d:\django projects\Full project code\adnan-game-animal\letter\admin.py", "Python", 0, 1, 0, 0, 1, 2, 4
"d:\django projects\Full project code\adnan-game-animal\letter\apps.py", "Python", 0, 4, 0, 0, 0, 3, 7
"d:\django projects\Full project code\adnan-game-animal\letter\consumers.py", "Python", 0, 113, 0, 0, 6, 15, 134
"d:\django projects\Full project code\adnan-game-animal\letter\migrations\__init__.py", "Python", 0, 0, 0, 0, 0, 1, 1
"d:\django projects\Full project code\adnan-game-animal\letter\models.py", "Python", 0, 1, 0, 0, 1, 2, 4
"d:\django projects\Full project code\adnan-game-animal\letter\routing.py", "Python", 0, 5, 0, 0, 0, 2, 7
"d:\django projects\Full project code\adnan-game-animal\letter\tests.py", "Python", 0, 1, 0, 0, 1, 2, 4
"d:\django projects\Full project code\adnan-game-animal\letter\views.py", "Python", 0, 1, 0, 0, 1, 2, 4
"d:\django projects\Full project code\adnan-game-animal\manage.py", "Python", 0, 15, 0, 0, 3, 5, 23
"d:\django projects\Full project code\adnan-game-animal\quiz\__init__.py", "Python", 0, 0, 0, 0, 0, 1, 1
"d:\django projects\Full project code\adnan-game-animal\quiz\admin.py", "Python", 0, 1, 0, 0, 1, 2, 4
"d:\django projects\Full project code\adnan-game-animal\quiz\apps.py", "Python", 0, 4, 0, 0, 0, 3, 7
"d:\django projects\Full project code\adnan-game-animal\quiz\consumers.py", "Python", 0, 190, 0, 0, 2, 32, 224
"d:\django projects\Full project code\adnan-game-animal\quiz\migrations\0001_initial.py", "Python", 0, 16, 0, 0, 1, 7, 24
"d:\django projects\Full project code\adnan-game-animal\quiz\migrations\0002_alter_mymodel_data.py", "Python", 0, 12, 0, 0, 1, 6, 19
"d:\django projects\Full project code\adnan-game-animal\quiz\migrations\0003_alter_mymodel_data.py", "Python", 0, 13, 0, 0, 1, 6, 20
"d:\django projects\Full project code\adnan-game-animal\quiz\migrations\0004_title.py", "Python", 0, 15, 0, 0, 1, 6, 22
"d:\django projects\Full project code\adnan-game-animal\quiz\migrations\0005_title_user.py", "Python", 0, 12, 0, 0, 1, 6, 19
"d:\django projects\Full project code\adnan-game-animal\quiz\migrations\0006_title_date.py", "Python", 0, 13, 0, 0, 1, 6, 20
"d:\django projects\Full project code\adnan-game-animal\quiz\migrations\0007_room_created.py", "Python", 0, 18, 0, 0, 1, 6, 25
"d:\django projects\Full project code\adnan-game-animal\quiz\migrations\0008_alter_room_created_room_created.py", "Python", 0, 12, 0, 0, 1, 6, 19
"d:\django projects\Full project code\adnan-game-animal\quiz\migrations\0009_title_edit.py", "Python", 0, 12, 0, 0, 1, 6, 19
"d:\django projects\Full project code\adnan-game-animal\quiz\migrations\0010_remove_title_edit.py", "Python", 0, 11, 0, 0, 1, 6, 18
"d:\django projects\Full project code\adnan-game-animal\quiz\migrations\0011_title_num.py", "Python", 0, 12, 0, 0, 1, 6, 19
"d:\django projects\Full project code\adnan-game-animal\quiz\migrations\0012_password.py", "Python", 0, 15, 0, 0, 1, 6, 22
"d:\django projects\Full project code\adnan-game-animal\quiz\migrations\0013_mymodel_delete.py", "Python", 0, 12, 0, 0, 1, 6, 19
"d:\django projects\Full project code\adnan-game-animal\quiz\migrations\0014_title_delete.py", "Python", 0, 12, 0, 0, 1, 6, 19
"d:\django projects\Full project code\adnan-game-animal\quiz\migrations\0015_enumeration.py", "Python", 0, 15, 0, 0, 1, 6, 22
"d:\django projects\Full project code\adnan-game-animal\quiz\migrations\0016_alter_mymodel_code.py", "Python", 0, 12, 0, 0, 1, 6, 19
"d:\django projects\Full project code\adnan-game-animal\quiz\migrations\0017_priv.py", "Python", 0, 15, 0, 0, 1, 6, 22
"d:\django projects\Full project code\adnan-game-animal\quiz\migrations\0018_played_quiz.py", "Python", 0, 15, 0, 0, 1, 6, 22
"d:\django projects\Full project code\adnan-game-animal\quiz\migrations\0019_alter_played_quiz_code.py", "Python", 0, 12, 0, 0, 1, 6, 19
"d:\django projects\Full project code\adnan-game-animal\quiz\migrations\0020_alter_played_quiz_unique_together.py", "Python", 0, 11, 0, 0, 1, 6, 18
"d:\django projects\Full project code\adnan-game-animal\quiz\migrations\0021_played_quiz_name.py", "Python", 0, 12, 0, 0, 1, 6, 19
"d:\django projects\Full project code\adnan-game-animal\quiz\migrations\0022_played_quiz_ids.py", "Python", 0, 12, 0, 0, 1, 6, 19
"d:\django projects\Full project code\adnan-game-animal\quiz\migrations\0023_alter_played_quiz_ids.py", "Python", 0, 12, 0, 0, 1, 6, 19
"d:\django projects\Full project code\adnan-game-animal\quiz\migrations\0024_alter_played_quiz_code_alter_played_quiz_ids.py", "Python", 0, 17, 0, 0, 1, 6, 24
"d:\django projects\Full project code\adnan-game-animal\quiz\migrations\0025_alter_played_quiz_ids.py", "Python", 0, 12, 0, 0, 1, 6, 19
"d:\django projects\Full project code\adnan-game-animal\quiz\migrations\__init__.py", "Python", 0, 0, 0, 0, 0, 1, 1
"d:\django projects\Full project code\adnan-game-animal\quiz\models.py", "Python", 0, 36, 0, 0, 0, 11, 47
"d:\django projects\Full project code\adnan-game-animal\quiz\routing.py", "Python", 0, 5, 0, 0, 0, 2, 7
"d:\django projects\Full project code\adnan-game-animal\quiz\tests.py", "Python", 0, 1, 0, 0, 1, 2, 4
"d:\django projects\Full project code\adnan-game-animal\quiz\views.py", "Python", 0, 1, 0, 0, 1, 2, 4
"d:\django projects\Full project code\adnan-game-animal\requirements.txt", "pip requirements", 201, 0, 0, 0, 0, 0, 201
"d:\django projects\Full project code\adnan-game-animal\templates\accounthome.html", "HTML", 0, 0, 62, 0, 0, 22, 84
"d:\django projects\Full project code\adnan-game-animal\templates\accounthome2.html", "HTML", 0, 0, 39, 0, 2, 7, 48
"d:\django projects\Full project code\adnan-game-animal\templates\base.html", "HTML", 0, 0, 217, 0, 21, 33, 271
"d:\django projects\Full project code\adnan-game-animal\templates\camera.html", "HTML", 0, 0, 101, 0, 0, 25, 126
"d:\django projects\Full project code\adnan-game-animal\templates\create.html", "HTML", 0, 0, 98, 0, 0, 19, 117
"d:\django projects\Full project code\adnan-game-animal\templates\created.html", "HTML", 0, 0, 97, 0, 0, 20, 117
"d:\django projects\Full project code\adnan-game-animal\templates\edit.html", "HTML", 0, 0, 505, 0, 0, 133, 638
"d:\django projects\Full project code\adnan-game-animal\templates\end.html", "HTML", 0, 0, 54, 0, 0, 16, 70
"d:\django projects\Full project code\adnan-game-animal\templates\endAdmin.html", "HTML", 0, 0, 329, 0, 0, 42, 371
"d:\django projects\Full project code\adnan-game-animal\templates\end_quiz_qr.html", "HTML", 0, 0, 251, 0, 1, 47, 299
"d:\django projects\Full project code\adnan-game-animal\templates\game.html", "HTML", 0, 0, 812, 0, 0, 167, 979
"d:\django projects\Full project code\adnan-game-animal\templates\gamequiz.html", "HTML", 0, 0, 192, 0, 0, 47, 239
"d:\django projects\Full project code\adnan-game-animal\templates\join.html", "HTML", 0, 0, 64, 0, 9, 27, 100
"d:\django projects\Full project code\adnan-game-animal\templates\joinqr.html", "HTML", 0, 0, 50, 0, 8, 25, 83
"d:\django projects\Full project code\adnan-game-animal\templates\joinquiz.html", "HTML", 0, 0, 63, 0, 9, 28, 100
"d:\django projects\Full project code\adnan-game-animal\templates\last_quiz.html", "HTML", 0, 0, 30, 0, 0, 12, 42
"d:\django projects\Full project code\adnan-game-animal\templates\last_quiz_preview.html", "HTML", 0, 0, 251, 0, 1, 47, 299
"d:\django projects\Full project code\adnan-game-animal\templates\login.html", "HTML", 0, 0, 177, 0, 85, 18, 280
"d:\django projects\Full project code\adnan-game-animal\templates\myaccount.html", "HTML", 0, 0, 13, 0, 74, 4, 91
"d:\django projects\Full project code\adnan-game-animal\templates\myactivity.html", "HTML", 0, 0, 269, 0, 3, 81, 353
"d:\django projects\Full project code\adnan-game-animal\templates\mygames.html", "HTML", 0, 0, 38, 0, 0, 16, 54
"d:\django projects\Full project code\adnan-game-animal\templates\password_enter.html", "HTML", 0, 0, 18, 0, 3, 5, 26
"d:\django projects\Full project code\adnan-game-animal\templates\played.html", "HTML", 0, 0, 10, 0, 0, 5, 15
"d:\django projects\Full project code\adnan-game-animal\templates\playedas.html", "HTML", 0, 0, 32, 0, 0, 8, 40
"d:\django projects\Full project code\adnan-game-animal\templates\qrcodes.html", "HTML", 0, 0, 18, 0, 0, 3, 21
"d:\django projects\Full project code\adnan-game-animal\templates\quiz.html", "HTML", 0, 0, 262, 0, 0, 61, 323
"d:\django projects\Full project code\adnan-game-animal\templates\quiz_data.html", "HTML", 0, 0, 121, 0, 4, 30, 155
"d:\django projects\Full project code\adnan-game-animal\templates\quizlist.html", "HTML", 0, 0, 81, 0, 1, 22, 104
"d:\django projects\Full project code\adnan-game-animal\templates\room.html", "HTML", 0, 0, 108, 0, 0, 28, 136
"d:\django projects\Full project code\adnan-game-animal\templates\roomAdmin.html", "HTML", 0, 0, 99, 0, 0, 18, 117
"d:\django projects\Full project code\adnan-game-animal\templates\signup.html", "HTML", 0, 0, 88, 0, 4, 20, 112
"d:\django projects\Full project code\adnan-game-animal\templates\startquiz.html", "HTML", 0, 0, 344, 0, 0, 92, 436
"d:\django projects\Full project code\adnan-game-animal\templates\startquiz_qr.html", "HTML", 0, 0, 849, 0, 3, 226, 1078
"d:\django projects\Full project code\adnan-game-animal\templates\startroom.html", "HTML", 0, 0, 950, 0, 0, 279, 1229
"d:\django projects\Full project code\adnan-game-animal\templates\type.html", "HTML", 0, 0, 74, 0, 0, 23, 97
"d:\django projects\Full project code\adnan-game-animal\templates\view_questions.html", "HTML", 0, 0, 269, 0, 0, 61, 330
"d:\django projects\Full project code\adnan-game-animal\templates\waiting.html", "HTML", 0, 0, 102, 0, 0, 22, 124
"d:\django projects\Full project code\adnan-game-animal\templates\waitingquiz.html", "HTML", 0, 0, 104, 0, 0, 25, 129
"Total", "-", 201, 5481, 7286, 3, 1205, 3270, 17446